WWWWWWWWWWWWWWW
S   WWW     W F
WWW WWW WWW W W
W   WWW   W W W
WWW     W W W W
W   WWWWW WW  W
W WW      WWW W
W WW WWWWWWWW W
W W           W
WWWWWWWWWWWWWWW
