WWWWWWWWWWWWWWW
W WW       WW F
W    WWWWW W  W
WWWW W   W WW W
S  W W W W W  W
WW W W WWWW  WW
W  W W     W WW
W WW  WW WW   W
W WWW     W W W
W     W W W W W
WWWW WW WWW   W
W  W W  W W WWW
W WW W    W   W
W     W W   W W
WWWWWWWWWWWWWWW
